15
10
lights:on
#####-#########
#*  # xttxxttx#
#+++#h++++++++#
#x+x#++       #
#   ++h++ ###x#
#  +++x+     h#
# ++ ######## #
#   ++  +  +  #
#   +x  +  x h#
###############
