14
10
lights:on
#####-########
#*  #hxxxxxxt#
#+++##+++++++#
#+ +##       #
#   ##   #####
#   ##      ##
#   ####### ##
#           ##
#           ##
##############
